0	204号室の住人は変な人だ。なんとドアノブを自分でDIYしてしまった。泥棒にでも入られたらどうするのか。侵入は容易だろう。
1	301号室の住人は美人でいい人だ。こんな私でも優しくしてくれ、訳ををきいてみたら夫が単身赴任で不在らしく似た境遇なので応援したくなるらしい。果たしてそうなのか…
2火災	郵便受けに怪しいチラシが入っていた。どうやら保険の勧誘みたいだ。たとえすべてが燃えようと私に失うものはない。
3地震	郵便受けに怪しいチラシが入っていた。どうやら保険の勧誘みたいだ。プレートはそうそうズレることはない。こういうのはお断りするのが世の常だ。
4株	夜遅くにチャイムが鳴った。どうやら海外の企業の未公開株を売ってくれるらしい。公開されれば莫大な額になるという…どうする…？
5詐欺	郵便受けに怪しいチラシが入っていた。なんと最高級のヒノキを使ったフランス産けん玉の通信販売だ！これは買わなくては！！
6詐欺	最近何かと物騒だ。ニュースをも暗いばかりで見る気にもならない。このチラシの壺を買えば運命は変わるかもしれない…
7詐欺	その電話は突然鳴り響いた…どうやら実家のお母さんが交通事故を起こしてしまい、相手に治療費を払わなくてないけないらしい。母ちゃん！俺が助けてやるからな！！
8火事イベント	あっちゃちゃあっちゃちゃ！火事だ火事だ！家財はすべて外へ！保険は入ってるか？あれば無駄な金を使わなくてすむ！
9火事イベント	わああ！火が家じゅうに！！もうだめだ！保険に入っとけば…！
10地震イベント	ん…？この揺れは…結構でかいぞ！家財はそとへ！保険に入れば家具が壊れても費用を負担してくれる！！
11地震イベント	その日人類は思い出した…地震の恐怖を…保険に入っていない屈辱を…
12火事と地震イベント	下は地震上は大火事ってなーんだ？え？全然違う？そんなことよりも家財を外へ出さなければ家具は燃え家は崩れてしまう！！保険に入ってれば少しは負担してくれたかな？
13株保険回避	昨日の勧誘はきっぱり断った。私にそんなお金はないしそもそもが怪しすぎる。相手が悪かったな。
14保険加入	人生に冒険は必要だし、たとえいくらお金がかかろうと命を守る費用としては安すぎるくらいだ私は迷わず加入した
15株加入	男の話はうさん臭かったが買ってみることにした。男も悪い人には見えなかったのでこの株が大金になってくれることを祈ろう。
16株1	株価はあまりよろしくないようだ。今は売るべきではないだろう。
17株2	株価はそこそこだ。今売れば損も得もしないってところだろうか。
18株3	株価はいい。売るなら今だろう。
19株4	株価は今までにないほど上がっている！すぐに売りさばくべきだ！！
20その他	特になにもなかった。